10 10
0000000000
0000000000
0000110000
0000110000
0000000000
0000000000
0000000000
0001110000
0000000000
0000000000