10 10
1111111111
1110000111
1111001111
1111111111
1111111111
1111111111
1111111111
1111111111
1111111111
1111111111